111111111111111111111111111111111111111111111111111111111111
111100000000011111111110000001111111111111111111111111111111
111000000000001111111100000000111111000000011111111111111111
111000000000001111111000000000111100000000001111111110000011
111000011100001111110000010000111100000000000111110000000001
111000111110001111110000111000111000000100000111110000000001
111000111110001111110001111000111000011110000111100000000001
111000011110000011110001111000111000111111000111000001110001
111000011110000001100001111000010000111111000110000011110001
111000011111000000000001111000010000111111000110000011110001
111000111111100000000001111000000000111111000000000111110001
111000111111111000000111111100000001111111000000001111110001
111000111111111111111111111110000001111111000000011111110001
111030111111111111111111111111000001111111000000111111100001
111000111111111111111111111111111111111111111111111111000001
111111111111111111111111111111111111111111111111111110000011
111111111111111111111111111111111111111111111111111100000011
111111111111000000011111110000000111000000111111110000000111
111111111100000000001111000000000000000000001110000000011111
111100011000000000000000000000000000000000000000000000111111
110000000000000100000000000011100000000000000000000001111111
100000000000011110000000000110011100001110000000001111111111
100000000000111111110001111000000111111111111111111111111111
100000000001111111111111100000000001111111111111111111111111
100000000111000000111111000000000001111111111111111111111111
100000001110000000011110000001100001111111111111111111111111
100000011000000000001000000011110001111111111111111111111111
100000010000000000000000000111110001111111111111111111111111
110000000000001100000000011111100001111110000000000001111111
111000000000111110000000111111100001111100000000000000111111
111100000011111111000011111111000001111100000000000000111111
111111111111111111111111111110000011111100000000000000111111
111111111111111111111111111100000011111100000000000000111111
111111111111111111111111110000000111111100000000000000011111
111111111100000000000100000000001111111100000000000000001111
111111111000000000000000000000011111111100000000000000001111
111111110000000000000000000001111111111100000000000000000111
111111110000011111000000111111111111111100000000000000000111
111111110000111111111111111111111111111100000000001110000011
111111110000111111111111111111111111111100000000001111000011
111111110000011111111111000001111111111100000000001111000011
111111110000011111111100000000011111111000000000001111100011
111111111000000111111000000000001111111000000000001111100011
111111111100000011000000000000000111110000000000001111100011
111111111110000000000000011100000111110000000000001111000011
111111111111000000000001111110000111110000000000001111000011
111111111111100000000111111111000111110000000000001111000011
111111111111111111111111111000000111110000000000001111000111
111111111111111111111111100000000111100000000000011110000111
111111111111111111111110000000000111000000000000011110000111
111111111111111111111110000000111111000000000000111110000111
111111111111111111111110000011111111000000000001111100001111
111111111111111111111110000000111111000000011111111100001111
111111111111111111111110000000000000000000111111111000001111
111111111111111111111111100000000000000001111111111000011111
111111111111111111111111111000000000000111111110000000011111
111111111111111111111111111111111111111111100000000000111111
111111111111111111111111111111111111111111102000000001111111
111111111111111111111111111111111111111111100000011111111111
111111111111111111111111111111111111111111111111111111111111
