111111111111111111111111111111111111111111111111111111111111
100000000000000000000000000000000000000000000000000000000031
100000000000000000000000000000000000000000000000000000000001
100011111111000000000000000000000000000000000000000000000001
100000000000000000000000000000000000000000000000000000000001
100000000000000000000011100000000000000000000000100000000001
100000000000000000000000011000000000000000000000100000000001
100000000000000000000000001110000000000000000000100000000001
100000000000000000000000000001110000000000000000100001111101
100000000000111111000000000000011100000000000000100000000001
100000000000000001111000000000000111111000000000100000000001
100000000000000000000110000000000000001111000000100000000001
100000000000000000000010000000000000000001000000100000000001
100000000000000000000010000000000000000000000000100000000001
100000000000000000000010000000000000000000000000100000000001
100000000111110000000110000000001100000000000000100000000001
100000001100011111111000000000011000000000000000100000000001
100000001000000000000000000000100000000000000011100000000001
100000001000000000000000000001100000000000111110000000000001
100000001000000000000000000000100000000111000000000000000001
100000001000000000000000000000100000001100000000000000000001
100000001000000000000000000000100000011000000000000000000001
100000001000000000000000000000110000010000000000000000110001
100000001000000000000000000000010000011000000000000000100001
100000000000000000000000000000010000001100000000000001100001
100000000000000000000000000000010000000000000000000011000001
100000000011110000000000000000010000000000000000000110000001
100000000010010000000000000000010000000000000000001100000001
100000000000010000000001111111110000000000000000111000000001
100000000000011000000000000000000000000000000000100000000001
100000000000001000000000000000000000000000000000100000000001
100000000000001000000000000000000000000000000001100000000001
100000000000001000000000000000000000000000100001000000000001
100000000000001000000000000000000000000100100001000000000001
100000000000001000000000000000000000000100100001000000000001
100000000000001000000000000000000000000111100001000000000001
100000000000001000000000000000000000000011000000000000000001
100000100000001000000000000000000000000000000000000000000001
100000110000001000000000000000000000000000000000000000000001
100000010000001100000000000011111111000000000000000000000001
100000010000000110000001111110000000000000000000000000000001
100000010000000011000111000000000000000000000000000000000001
100000010000000000111100000000000000000000000000000000000001
100000001000000000000000000000000000000000000001100000000001
100000001000000000000000000000000000000000000011000000000001
100000001000000000000000000000000000000000000110000000000001
100000001000000000000000000000000000000000111100000000000001
100000001000000000000000000000000000000001100000000000000001
100000001000000000000000000000000000000010000000000000000001
100000001100000000000000000100000000000110000000000000000001
100000000011000000000000000110000000000100000000000000000001
100000000001111111000000000010000000000100000000000000000001
100000000000000000000000000010000000000100000000000111111001
100000000000000000000000000011000000000100000000000000000001
100000000000000000000000000011000000000000000000000000000001
100000000000000000000000000110000000000000000000000000000001
100000000000000000000000001100000000000000000000000000000001
100000000000000000000000011000000000000000000000000000000001
100000000000000000000000000000000000000000000000000000000001
111111111111111111111111111111111111111111111111111111111111
