111111111111111111111111111111111111111111111111111111111111
111111111111111111111111111111111111111111111111111111111111
111111111111111111111111111111111110000011111111111111111111
111111111111111111111111111111111110030011111111111111111111
111111111111111111111111111111111110000001111111111111111111
111111111111111111111111111111111110000000000001111111111111
111111111111111111111111111111111110000000000000111111111111
111111111111111111111111111111111110000000000000000000111111
111111111111111111111111111111111111100000000000000000111111
111111111111111111111111111111111111111111100000000000011111
111111111111111111111111111111111111111111111110000000011111
111111111111111111111111111111111111111111111111000000000001
111111111111111111111111111111111111111111111111100000000001
111111111111111111111111111111111111111111111111100000000001
111111111111111111111111111111111111111111111111100000000001
111111111111111111111111111111111111111111100000000000000011
111111111111111111111111111111111111111100000000000000000111
111111111111111111111111111111111000000000000000000000001111
111111111111111111111111111111110000000000000000000000111111
111111111111111111111111111111100000000000000001111111111111
111111111111111111111111111111000000000011111111111111111111
111111111111111111111111111110000000000111111111111111111111
111111111111111111111111111110000000001111111111111111111111
111111111111111111111111111110000000011111111111111111111111
111111111111111111111111111110000000111111111111111111111111
111111111111111111111111111110000000111111111111111111111111
111111111111111111111111111111000000011111111111111111111111
111111111111111111111111111111000000001111111111111111111111
111111111111111111111111111111000000000111111111111111111111
111111111111111111111111111111000000000011111111111111111111
111111111111111111111111111111100000000001111111111111111111
111111111111111111111111111111110000000000011111111111111111
111111111111111111111111111111111000000000000111111111111111
111111111111111111111111111111111100000000000001111111111111
111111111111111111111111111111111111000000000000011111111111
111111111111111111111111111111111111100000000000001111111111
111111111111111111111111111111111111110000000000000111111111
111111111111111111111111111111111111111100000000000011111111
111111111111111111111111111111111111111111000000000001111111
111111111111111111111111111111111111111111110000000001000111
111111111111111111111111111111111111111111111000000000000111
111111111111111111111111111111111111111111111100000000000111
111111111111111111111111111111111111111111111110000000000111
111111111111111111111111111111111111111111111111000000000111
111111111111111111111111111111111111111111111111000000001111
111111111111111111111111111111111111111111111110000000011111
111111111111111111111111111111111111111111111000000000011111
111111111111111111111111111111111111111111100000000000011111
111111111111111111111111111111111111111111000000000000011111
111111111111111111111111111111111111111110000000000000011111
111111111111111111111111111111111111111100000000000011111111
111111111111111111111111111111111111111100000000001111111111
111111111111111111111111111111111111111100020000111111111111
111111111111111111111111111111111111111110000011111111111111
111111111111111111111111111111111111111111111111111111111111
111111111111111111111111111111111111111111111111111111111111
111111111111111111111111111111111111111111111111111111111111
111111111111111111111111111111111111111111111111111111111111
111111111111111111111111111111111111111111111111111111111111
111111111111111111111111111111111111111111111111111111111111
